width=10 height=10 playable=[😀] blocking=[🌲,😀] nonblocking=[_,.,🏠,.]
🌲🌲🌲🌳🌲🌲🌲🌲🌲🌲
🌲_.......🌲
🌲........🌲
🌲........🌲
🌲........🌲
🌲....🏠...🌲
🌲........🌲
🌲........🌲
🌲........🌲
🌲🌲🌲🌳🌲🌲🌲🌲🌲🌲
